NO   ./sprites/00/NO.png
SO   ./sprites/00/SO.png
WE   ./sprites/00/WE.png
EA   ./sprites/00/EA.png

F 0,200,0
C 150,206,256 

11111111111111111111111111111111  1111111
11000000000000000000000100001101  1000001
1111111111111111101111011111111   1111111
                1010000111
                10111111111111111111111111111111111111111111
    11111111    100000000000000000000000000000000000000000001
    10101001    11111111111000000000000001111111111111111111
    10100001        1111111000000000000001
    11111111        100000000000000000000111111111111111111
                    100000000000000000000000000000000000001
    1111111111111111111110000111111110111111111111111111001
    100000000000000000000000010000011011          100011101
    111111111111111111111100111101110001         1000000001
  111111111111111111111111001111D11100011111111111111111111
111W0000000000000000000000000000000000000000000000000000001
11100000000000000000000000000000000000000000000000000000001
11110000000000000000000000000000000000000000000000000000001
11111111111111111111111111111111111111111111111111111111111