NO   ./sprites/00/NO.png
SO   ./sprites/00/SO.png
WE   ./sprites/00/WE.png
EA   ./sprites/00/EA.png

F 0,200,0
C 150,206,235

1111111111111111111111111111111111
1000000000000000000100000010000D01
10000000000000000001110000111D1101
10000E00000000000000000000000001D1
1000000000000000000000000000000101
1111111111111111111111111111111111