NO   ./sprites/00/NO.png
SO   ./sprites/00/SO.png
WE   ./sprites/00/WE.png
EA   ./sprites/00/EA.png

C 0,0,0
F 255,255,255

                                                                                             111
111              111                                                                         101
1011          1111011111111111111     111         111                                        111
11011         1010000000010100001     1011111     101     111
 1001111      1110000000000000001     1110101     111     101                  111
 1100101        10010010110101011      111111             11111        111     101
  110111        100000111001010011     101                  101111     1011    111
   1101         100000000001010001     111        1111111111111101     1001
    1011        100010010000010011    111       111000000000000111     1001
    110111      10000000001001001     101       1000000000000111       1001
    11101      10000010101000001     111      110000000000001         100111
       101      10100000110001001              100000000001111        1100001
       1011     10100001010100001              1100000000111          11000001
       1101     10100010110000001          11111000000011           1100100011 111
        101     10100100010100011          1011000000011           11000000001 101
        11111  110110011110000011          101100N00001            100000000011111          111
      111 101  100100001000001001       111101000000001            100000000001             101
      1011111  100100001000101001       101101000000011            100000000001             111
      11101 111100000100110001001       11110010000001            11000000000011
       11111101100000000000011011          11000000001            10000000000001
       101 1011100000001000001011          10010000001            10000000000001
  111  111 1111000000000000001001111  111  11000000001111        1100001000000011
  101         1100000001100101001101  101  10010000001101        1000001110000001    111
  111          1101000000000101011111 111  11000000001111  1111111000011011000001    101
              1001000011011000010101 111  10000000001     101011000001101111000111  111
               1110000010010110111111 1011111000000001     111111001111100111000101
               10000000100000001      1110010000000001          1011   101101000111
               11000001000000001111     11111000000001       111101    1011111001
               10000010100100001101111     10000000001 111111101111    111   1001
               10000011010110001111001 111 11000000001110110111110111        1001
           111 10000000100000101  1111 101  10100000010111111 1011101     1111001
        111101 10000000101100001      1101  1010000001100111  1111011     1011001
        101111 10100000010000101      1001  1110000001000001111111111111  1111001                 111
       1111    1101000100010000111  111011  1010000001011100000000000001111110001  111            101
       101     1000101100010100101 110111   1111000001011111111111111100000000111  101            111
       111     100000010010011001111010111   1000000010101   111  1111110000011 111111
              1100000010010000001001010101   1100000010111   10111100000000001  1001
           1111000000110000010000111111101  110000000101     11011011111110001  1111   111
      111  100101100011010000100100010101111100010000001     1111101     10011         101  111
      101  111111001010001001000111111111 10100000000001     1011001     1001          111  1011
      111       10010110100001011 1101    10001000000011     1111001    11001     111      11101
            11111000011100010100111011    1100000011001     111 1001    10001     101      10111
            1011000101101000000011011   111110010100001     10111001    10011     111      111
111        111110010011000000000001111  101101000001001 111 10011001    10001
101        101 10010000010000000111001  101111101001101 101 10001101111 10001
111        111 100000000001000001 1111 11111010010010011111 10000101101 10001111
               100100100000000001      101 11001100101101   10000101111 11001101
               100000000000000001111   1111 1110001101111   11000101     1001111
               110000100000110000101   1001 1010101001       1100101    110001     111
               101001000001010001111   1101 1110001001111     100001    1000011    101
               10100000101010010101    1011   1001110110111   100001    1110001    111
               10100000001000000111    1111 111100000111101   110001   11110001
     111       110000100000000001 111111101 1010000101  101    10001   101111011
     101        10000000000000001 101101101 1111000001  1111   11001   111  1001111
     111       110000100100000001 111111111   100000011  101    1001        1101101     111
               101100000000000001   111  11111101000001  1111   1001         100111     101
               110100100000000001 11101  1011011000010111 101   1101 111111  100011  111111
                11000010000000001110101111111100100010101 111 111101 101101  110001  101
                10000000000000000000001010111111010010111111  101101 1111111  10001  111
                1010010000000000000000000100110100001001 101  111111     101  11001111
               110010000000000000000000000000000001011011111  111        111   1000101   111
               10001010000000001111000000000000010101101101   101      111     1101111   101
           1111110100000000000011 11100000010000000011011011  111      101      1001     111
           1010100100011000000001   1000000000000001110011011          111      1001
           1101101000110000000001   1011000001111000111011101    111            1101111
            1111000001100000000011111111100010011000111011101    101   111       110101    111 111
   111         101001010000000011101  11111111111000110011011    111   101        1011111  101 101
   101         10000000000000001 111  101     10100000010111           111        101 1011 111 111
   111         10010100010000001      111     110000111111                        111 1101
               10100101010000001               110001  101            111       111   1111
               10010000010000001                101011 111           1101     11101   101
               10000010010000001 111           110110111             1011     10111   111    111
             11101010000000100011101           1010110011            111      111111         101
             10101000100000000010111           111101110111          101         101         111
             111010001000000000111               10111010011       11111         111
               10000000000100001                 100111111011111  110111 111                111
               10001000100000001    111  111    11101    111100111101101 101                101
               10000000100000101    101  101    10101     10110101011111 101                111
               10001000100000001    111  111    11111     1111111111     111 111          111
               10100001000000001   111 111111                                101          101
               10011010000000011   101 101101                                111          111
               1001001001100001111 111 11111111
               10001010000000010011   111   101    111                  111        111
               10010110111000011101   101   111    10111                101        101
              11000110010000001 111   111   101    11101        111    111111      111
              10000011010100001             111      11111      101    101101
              10000110011000101                        101      111    111111                     111
              10011000010000101                        111        111                             101
              11010000111000101                                   101                             111
               1001101000000101                                   111                   111
               1000010000000001                                                         101
               1110000000000001                                                         111
                 11111111111111
 
                                                                                     111
                                                                                     101
                                                                                     111
                                                                                                   111
                                                                                                   101
                                                                                                   111
