11111111111111111111111
1P000000000011100C000E1
100000C0011010001001111
1C000000011010001001111
10000000011010001001111
1CCCCCCCCCCCCCCCCCCCCC1
11111111111111111111111