11111111111111111111111111111
1P000000000000000000000000001
10000000000000000000000000001
10010000000000000000000000001
10101000000000000000E00000001
10010000000000000000000000001
11111111111111111111111111111