1111111111111111111111111111111111
1E0000000000Z00C00000C000000000001
1010010100100000101001000000010101
1110010010101010001001000000010101
1P10Z0000C00CZ00000000000000000C0
1111111111111111111111111111111111