1111111
1P00001
101C101
1111101
1E01001
1111111